###.#
#...#
###.#
#...#
#.###
